# Resources from graph.properties
alreadyConnected=Узлы уже соединены
cancel=Отмена
close=Закрыть
collapse-expand=Свернуть/Развернуть
containsValidationErrors=Содержит ошибки валидации
done=Выполнено
doubleClickOrientation=Сделайте двойной клик для изменения ориентации
error=Ошибка
errorSavingFile=Ошибка при сохранении файла
ok=OK
updatingDocument=Документ обновляется. Подождите...
updatingSelection=Выбор обновляется. Подождите...
# Custom resources
about=О Программе
actualSize=Фактический размер
add=Добавить
addLayer=Добавить слой
addProperty=Добавить свойство
addToExistingDrawing=Добавить в существующую схему
addWaypoint=Добавить промежуточную точку
advanced=Продвинутые
align=Выравнивание
alignment=Выравнивание
allChangesLost=Все изменения будут потеряны!
angle=Угол
apply=Применить
arc=Arc
arrange=Arrange
arrow=Стрелка
arrows=Стрелки
automatic=Автоматически
autosave=Автосохранение
autosize=Автоизменение размера
background=Фон
backgroundColor=Цвет фона
backgroundImage=Изображение фона
basic=Базовый
block=Блокировать
blockquote=Цитата
bold=Жирный
border=Граница
borderWidth=Ширина границы
borderColor=Цвет границы
bottom=Низ
bottomAlign=Выравнивание по низу
bottomLeft=Низ Лево
bottomRight=Низ Право
bulletedList=Список с точками
cannotOpenFile=Невозможно открыть файл
center=Центр
change=Изменить
changeOrientation=Изменить ориентацию
circle=Окружность
classic=Классический
clearDefaultStyle=Очистить стили по умолчанию
clearWaypoints=Очистить промежуточные точки
clipart=Изображения
collapse=Свернуть
collapseExpand=Свернуть/Развернуть
collapsible=Сворачиваемый
comic=Комичный
connect=Соединить
connection=Соединение
connectionPoints=Точки соединения
connectionArrows=Стрелки соединения
constrainProportions=Ограничить Пропорции
copy=Копировать
copyConnect=Копирова для соединения
copySize=Скопировать размер
create=Создать
curved=Кривая
custom=Собственный
cut=Вырезать
dashed=Прерывистая
decreaseIndent=Уменьшить отступ
default=По уполчанию
delete=Удалить
deleteColumn=Удалить колонку
deleteRow=Удалить строку
diagram=Диаграмма
diamond=Ромб
diamondThin=Ромб (тонкий)
direction=Направление
distribute=Распредилить
divider=Разделитель
documentProperties=Свойства документа
dotted=Пунктирный
drawing=Схема{1}
drawingEmpty=Схема пуста
drawingTooLarge=Схема слишком большая
duplicate=Дублировать
duplicateIt=Дубликат {1}
east=Восток
edit=Редактировать
editData=Редактировать данные
editDiagram=Редактировать диаграмму
editImage=Редактировать изображение
editLink=Редактировать ссылку
editStyle=Редактировать стили
editTooltip=Редактировать подсказку
enterGroup=Введите группу
enterValue=Введите значение
enterName=Введине название
enterPropertyName=Введите название свойства
entityRelation=Отношение сущности
exitGroup=Выйти из группы
expand=Расширить
export=Экспортировать
extras=Дополнительно
file=Файл
fileNotFound=Файл не найден
filename=Имя файла
fill=Заполнить
fillColor=Заполнить цветом
fitPage=Одна страница
fitPageWidth=Ширина страницы
fitTwoPages=Две страницы
fitWindow=По размеру окна
flip=Развернуть
flipH=Развернуть по горизонтали
flipV=Развернуть по вертикали
font=Шрифт
fontFamily=Семейство Шрифта
fontColor=Цвет Шрифта
fontSize=Размер Шрифта
format=Формат
formatPanel=Панель форматов
formatPdf=PDF
formatPng=PNG
formatGif=GIF
formatJpg=JPEG
formatSvg=SVG
formatXml=XML
formatted=Отформатированый
formattedText=Отформатированный текст
gap=Промежуток
glass=Стекло
general=Общее
global=Глобальные
gradient=Градиент
gradientColor=Цвет градиента
grid=Сетка
gridSize=Размер сетки
group=Группа
guides=Линейка
heading=Заголовок
height=Высота
help=Help
hide=Спрятать
hideIt=Спрятать {1}
hidden=Спрятан
home=Домой
horizontal=Горизонтально
horizontalFlow=Горизонтальная последовательность
horizontalTree=Горизонтальная иерархия
html=HTML
id=ID
image=Изображение
images=Изображения
import=Импорт
increaseIndent=Увеличить отступ
insert=Вставить
insertColumnBefore=Вставить колонку слева
insertColumnAfter=Вставить колонку справа
insertHorizontalRule=Вставить горизонтальную линейку
insertImage=Вставить изображение
insertLink=Вставить ссылку
insertRowBefore=Вставить строку выше
insertRowAfter=Вставить строку ниже
invalidName=Неправильное имя
invalidOrMissingFile=Неправильный или невалидный файл
isometric=Изометрический
italic=Курсив
layers=Слои
landscape=Пейзаж
laneColor=Цвет полосы
layout=Размещение
left=Слева
leftAlign=Выровнять по левой стороне
leftToRight=Выровнять по правой стороне
line=Линия
link=Ссылка
lineJumps=Прыжки линии
lineend=Конец линии
lineheight=Высота линии
linestart=Начало линии
linewidth=Ширина линии
loading=Загрузка
lockUnlock=Заблокировать/Разблокировать
manual=Ручной
middle=Середина
misc=Разное
more=Больше
moreResults=Больше результатов
move=Переместить
moveSelectionTo=Переместить выбранное в {1}
navigation=Навигация
new=Новый
noColor=Нет цвета
noFiles=Нет файлов
noMoreResults=Больше нет результатов
none=Пусто
noResultsFor=Нет результатов для '{1}'
normal=Нормальный
north=Север
numberedList=Нумерованый список
opacity=Прозрачность
open=Открыть
openArrow=Открытая стрелка
openFile=Открыть файл
openLink=Открыть ссылку
openSupported=Поддерживаемый формат это .XML файл сохраненный с помощью этого программного обеспечения
openInNewWindow=Открыть в новом окне
openInThisWindow=Открыть в этом окне
options=Опции
organic=Органический
orthogonal=Ортогональный
outline=Добавить контур
oval=Овал
pages=Страницы
pageView=Вид страницы
pageScale=Масштаб страницы
pageSetup=Настройки страницы
panTooltip=Перетаскивайте с нажатым пробелом для прокрутки
paperSize=Размер бумаги
paste=Вставить
pasteHere=Вставить сюда
pasteSize=Вставить размер
pattern=Шаблон
perimeter=Периметр
placeholders=Подстановки
plusTooltip=Click to connect and clone (ctrl+click to clone, shift+click to connect). Drag to connect (ctrl+drag to clone).
portrait=Портретный
position=Позиция
posterPrint=Печать постера
preview=Предварительный просмотр
print=Печать
radialTree=Радиальная иерархия
redo=Отмена
removeFormat=Очистить форматирование
removeFromGroup=Удалить из группы
removeIt=Удалить {1}
removeWaypoint=Удалить промежуточную точку
rename=Переименовать
renameIt=Переименовать {1}
replace=Заменить
replaceIt={1} уже существует. Вы действительно хотите его заменить
replaceExistingDrawing=Заменить текущую схему
reset=Сброс
resetView=Сброс представления
reverse=Обратить
right=Право
rightAlign=Выровнять по правой стороне
rightToLeft=Справа на лево
rotate=Вращать
rotateTooltip=Кликнить и начните перетаскивание для вращения, одиночный клик для вращения на 90 градусов
rotation=Вращение
rounded=Скругленный
save=Сохранить
saveAs=Save as
saved=Saved
scrollbars=Полосы прокрутки
search=Поиск
searchShapes=Поиск фигур
selectAll=Выбрать все
selectEdges=Выбрать ребра
selectFont=Выбрать шрифт
selectNone=Очистить выбор
selectVertices=Выбрать вершины
setAsDefaultStyle=Установить как стиль по умолчанию
shadow=Тень
shape=Форма
sharp=Резкость
sidebarTooltip=Кликните что бы развернуть. Перетаскивайте фигуры на диграмму. Используйте Shift+клик для изменения выбра и Alt+клик для вставки и соединения
simple=Простой
simpleArrow=Простая стрелка
size=Размер
solid=Сплошной
sourceSpacing=Source Spacing
south=Юг
spacing=Spacing
straight=Прямая
strokeColor=Цвет линии
style=Стиль
subscript=Нижняя сноска
superscript=Верхняя сноска
table=Таблицы
targetSpacing=Target Spacing
text=Текст
textAlignment=Выравниваение текста
textOpacity=Прозрачность текста
toBack=Назад
toFront=К верху
tooltips=Подсказки
top=Верх
topAlign=Выравнивание по верху
topLeft=Верх лево
topRight=Верх право
transparent=Прозрачный
turn=Вращение фигуры на 90 градусов
uml=UML
underline=Подчеркивание
undo=Отменить
ungroup=Разгруппировать
url=URL
untitledLayer=Неназваный слой
vertical=Вертикальный
verticalFlow=Вертикальная последовательность
verticalTree=Вертикальная иерархия
view=Вид
waypoints=Промежуточные точки
west=Запад
width=Ширина
wordWrap=Перенос слов
writingDirection=Направление письма
zoom=Масштаб
zoomIn=Увеличить масштаб
zoomOut=Уменьшить масштаб
